1111111111111
10P0000000001
1000C000001
1000000000001
100000000E1
1111111111111
