111111111111111111111111111
10P00001000C000000000000001
100000010000000000000000001
100000010000000010000000001
100000000000000010000000001
1000000000000000100000000E1
111111111111111111111111111
