111111111111111111111111111
10P000110N0C000000000N00001
100000110000000000000000001
100000110000000011000000001
10000011C000000011000000001
100000111100000011000000001
10000C111100000011000000001
100000000000000C11000000001
1N0000000000000011N000000E1
111111111111111111111111111
