1111111111111
10P0000000001
1000C000000E1
1000000000001
1000000000001
1000000000001
1000C000000E1

1000000000N01
1000000000001
1000000000001
1000C00000N01
1000000000001
1000000000001
1000000000001
1111111111111
