1111111111111
10P0100000001
1001C10000001
1001111111001
10010000000E1
1111111111111
