1111111111111
10P0000000001
1000C00000001
1000000000001
10000E00000E1
1111111111111
