11111111111111111111
1C01000C00000001N0C1
1N000111110000N10001
1P00111E000C00000001
11111111111111111111
